vvvvvvvvvvvvvvvvvvvvvvv
vvvvvvvvvvvvvvvvvvvvvvv
vvvvvvvvvvvvvvvvvvvvvvv
vvvvvvvvvvvvvvvvvvvvvvv
vvvvvvvvvvvvvvvvvvvvvvv
vv1111111111111111111vv
vv1222222221222222221vv
vv1211211121211121121vv
vv1211211121211121121vv
vv1222222222222222221vv
vv1211212111112121121vv
vv1222212221222122221vv
vv1111211121211121111vv
vv1111212222222121111vv
vv1111212111112121111vv
vv3222222100012222224vv
vv1111212111112121111vv
vv1111212222222121111vv
vv1111212111112121111vv
vv1222222221222222221vv
vv1211211121211121121vv
vv1221222222222221221vv
vv1121212111112121211vv
vv1222212221222122221vv
vv1211111121211111121vv
vv1222222222222222221vv
vv1111111111111111111vv
vvvvvvvvvvvvvvvvvvvvvvv
vvvvvvvvvvvvvvvvvvvvvvv
vvvvvvvvvvvvvvvvvvvvvvv